11111111111111111111111111111111
1..............C.........E.....1
1..............................1
1....1..1..1..1..1..1..1..1....1
1....1.51.51.51..1.51.51.51....1
1....1111111111..1111111111....1
1....17.17.17.1..17.17.17.1....1
1....1..1..1..1..1..1..1..1....1
1...................C..........1
1...............C..............1
1....1..1..1..1..1..1..1..1....1
1P...1.51.51C51..1.51.51.51....1
1....1111111111..1111111111.E..1
1....17.17.17.1..17.17.17.1....1
1....1..1..1..1..1..1..1..1....1
1..............................1
1..............................1
1....1..1..1..1..1..1..1..1....1
1....1.51.51.51..1.51.51.51....1
1....1111111111..1111111111....1
1....17.17.17.1..17.17.17.1....1
1....1..1..1..1..1..1..1..1....1
1..............................1
11111111111111111111111111111111